W,B,W,W,W,W,W,W,W,W,W,W,W,W
W,W,B,W,G,W,W,W,W,W,B,B,W,W
W,W,W,W,G,B,B,B,W,W,G,W,W,L
W,B,B,G,B,B,B,B,B,B,W,W,W,W
G,G,B,B,B,W,B,B,W,B,W,W,W,W
B,B,B,W,B,B,B,B,B,B,W,W,W,W
B,B,B,B,B,B,B,B,B,B,B,B,W,B
B,B,W,B,B,B,B,B,B,B,B,W,W,W
B,B,B,B,B,B,B,B,B,B,B,B,B,W
W,W,B,B,B,B,B,B,B,B,B,W,W,W
W,W,W,B,B,B,W,W,B,B,B,B,G,W
W,W,W,W,B,B,W,W,B,W,B,B,W,W
W,W,W,W,B,B,W,W,B,W,B,W,W,W
W,W,W,W,B,W,W,W,W,W,W,W,G,B
