L;L;L;L;L;L;L;L;L;L;L;L;L;L
L;L;L;L;L;L;L;L;L;W;W;W;W;L
L;L;L;L;L;L;L;L;L;W;W;W;G;W
L;L;L;L;L;W;A;A;A;B;W;W;W;W
W;G;W;L;L;L;B;B;B;B;B;B;B;B
W;W;W;L;L;L;R;B;B;B;B;B;B;B
W;W;B;B;B;B;B;B;B;B;B;B;B;B
W;B;B;B;B;B;W;B;B;B;B;B;B;B
B;B;B;B;B;W;B;B;B;B;B;B;B;W
B;B;B;B;B;B;B;B;B;B;B;B;B;B
B;B;B;B;G;B;B;G;B;B;B;B;B;B
W;B;B;B;B;G;B;B;B;W;W;B;B;W
B;B;W;W;B;B;B;W;B;W;W;W;B;W
G;W;W;W;B;B;W;G;G;W;W;B;B;B
